1111111111
1C0000E0P1
1111111111