1111111111
1E10101011
1C10101011
10C0101011
1111110011