111111111111
1EC01P111111
100000000001
111111111111