1111111111
100010P111
1001000011
100C001E11
1111111111