1111111101
100010P111
1001001011
100C001E11
1111111111